2 13 31
###############################
#p *      *2    **f *   *5  * #
# # # #s# # # # # # # # # #x# #
#    *    * *    *     3      # 
#b# # # # # # # #*# # # # # # #
#*    * * f   *   b   *   *   #
# #*# # # # # # #*# # # # # # #
#  d x  4  *   *      *    *  #
#*# # # #*# # # # # # # # # # #
#     *        *     ***      #
# # #*# # # # # # # # # # #*# #
# * 1  *    **   s   **       #
###############################