3 13 31
###############################
# *** 1   f    *       *   b  #
# # #*# # # # # # # #*#*# # # #
# *2     f      b       x2    #
# # # # # # #*# # #*# # # #f# #
#  *    *   1  *     * *      #
# # # #*# # # # # # # #*# # # #
#*  2    *    b         ** 1  #
#*# # # #*# # # # # #*# # # # #
#   **     *     *       *    #
# #*# #*# # #*# #*# # # # # # #
#p      s    * 1  *    *   2  #
###############################