2 13 31
###############################
#p *      *1    **f *   *   * #
# # # #s# # # # # # # # # #x# #
#    *    * *    *     2      # 
#b# # # # # # # #*# # # # # # #
#*    * * f   *   b   *   *   #
# #*# # # # # # #*# # # # # # #
#    x     *   *     1*    *  #
#*# # # #*# # # # # # # # # # #
#     *        *     ***      #
# # #*# # # # # # # # # # #*# #
# * 2  *    **   s   **       #
###############################