3 13 31
###############################
# *** 2   f    *4      *   b  #
# # #*# # # # # # # #*#*# # # #
# *3     f      b  3    y2    #
# # # # # # #*# # #*# # # #f# #
#  *    * d 5  *   6 * *  1   #
# # # #*# # # # # # # #*# # # #
#*  2    *    b         ** 1  #
#*# # # #*# # # # # #*# # # # #
#   **     *     *    5  *    #
# #*# #*# # #*# #*# # # # # # #
#p      s    * 6  *    *   2  #
###############################